{
  "level": 1,
  "startNode": [15,10],
  "endNode": [4,0],
  "nodes": [
    [0, 0, 0, 0, 0, 11, 0, 0, 0, 0, 0, 0, 0],
      [0, 0, 2, 0, 0, 1, 0, 0, 0, 0, 0, 0, 0],
    [0, 0, 0, 0, 0, 2, 1, 1, 0, 0, 0, 0, 0],
      [0, 2, 0, 0, 0, 0, 0, 1, 0, 0, 0, 0, 0],
    [0, 0, 0, 0, 2, 0, 0, 0, 1, 1, 1, 0, 0],
      [0, 0, 0, 0, 0, 0, 0, 0, 0, 1, 0, 0, 0],
    [0, 0, 0, 0, 0, 0, 1, 1, 0, 1, 0, 0, 0],
      [0, 0, 0, 0, 0, 1, 0, 1, 1, 0, 0, 0, 0],
    [0, 0, 0, 0, 0, 1, 0, 0, 0, 0, 0, 0, 0],
      [0, 0, 0, 0, 1, 0, 0, 0, 0, 0, 0, 0, 0],
    [0, 0, 0, 0, 1, 0, 1, 1, 0, 0, 0, 0, 0],
      [0, 0, 2, 1, 0, 1, 0, 1, 0, 0, 0, 0, 0],
    [0, 0, 0, 0, 1, 1, 0, 0, 1, 0, 0, 0, 0],
      [0, 0, 2, 0, 0, 0, 0, 0, 1, 1, 0, 0, 0],
    [0, 0, 0, 0, 0, 0, 2, 0, 0, 0, 1, 0, 0],
      [0, 0, 0, 0, 0, 0, 0, 0, 0, 0, 21, 0, 0]
  ]
}